0,1567.15,inf,4.31
1,1717.16,inf,4.31
2,1927.16,inf,4.31
3,1927.16,inf,4.31
4,1807.16,inf,4.31
5,1747.16,inf,4.31
6,1777.16,inf,4.31
7,1807.16,inf,4.31
8,1927.16,inf,4.31
9,1837.16,inf,4.31
10,1867.16,inf,4.31
11,1777.16,inf,4.31
12,1747.16,inf,4.31
13,1897.16,inf,4.31
14,1807.16,inf,4.31
15,1927.16,inf,4.31
16,1747.16,inf,4.31
17,1807.16,inf,4.31
18,1927.16,inf,4.31
19,1777.16,inf,4.31
20,1897.16,inf,4.31
21,1627.15,inf,4.31
