0,3339.07,inf,3.31
1,3500.14,inf,3.31
2,3339.07,inf,3.31
3,3339.07,inf,3.31
4,3016.94,inf,3.31
5,3097.47,inf,3.31
6,3097.47,inf,3.31
7,3097.47,inf,3.31
8,2694.81,inf,3.31
9,3097.47,inf,3.31
10,2775.34,inf,3.31
11,2372.67,inf,3.31
12,2372.67,inf,3.31
13,2372.67,inf,3.31
14,2372.67,inf,3.31
15,2211.61,inf,3.31
16,1808.94,inf,3.31
17,2372.67,inf,3.31
18,2453.21,inf,3.31
19,2453.21,inf,3.31
20,2453.21,inf,3.31
21,2453.21,inf,3.31
