0,2131.07,inf,3.41
1,2936.41,inf,3.41
2,3339.07,inf,3.41
3,3178.01,inf,3.41
4,2775.34,inf,3.41
5,3178.01,inf,3.41
6,3178.01,inf,3.41
7,3178.01,inf,3.41
8,3097.47,inf,3.41
9,3500.14,inf,3.41
10,3500.14,inf,3.41
11,3419.61,inf,3.41
12,3097.47,inf,3.41
13,2372.67,inf,3.41
14,2372.67,inf,3.41
15,2372.67,inf,3.41
16,2372.67,inf,3.41
17,2372.67,inf,3.41
18,2372.67,inf,3.41
19,2372.67,inf,3.41
20,2372.67,inf,3.41
21,2372.67,inf,3.41
