0,311.46,inf,1.41
1,311.46,inf,1.41
2,311.46,inf,1.41
3,311.46,inf,1.41
4,311.46,inf,1.41
5,311.46,inf,1.41
6,311.46,inf,1.41
7,311.46,inf,1.41
8,311.46,inf,1.41
9,311.46,inf,1.41
10,394.19,inf,1.41
11,441.47,inf,1.41
12,476.92,inf,1.41
13,358.73,inf,1.41
14,311.46,inf,1.41
15,323.28,inf,1.41
16,400.10,inf,1.41
17,429.65,inf,1.41
18,406.01,inf,1.41
19,358.73,inf,1.41
20,435.56,inf,1.41
21,411.92,inf,1.41
