0,3983.34,inf,4.51
1,3580.67,inf,4.51
2,4224.94,inf,4.51
3,4547.07,inf,4.51
4,4547.07,inf,4.51
5,4386.01,inf,4.51
6,4627.61,inf,4.51
7,4627.61,inf,4.51
8,4466.54,inf,4.51
9,4627.61,inf,4.51
10,4466.54,inf,4.51
11,4466.54,inf,4.51
12,4547.07,inf,4.51
13,4305.47,inf,4.51
14,4305.47,inf,4.51
15,3580.67,inf,4.51
16,3580.67,inf,4.51
17,2453.21,inf,4.51
18,2453.21,inf,4.51
19,1325.74,inf,4.51
20,1325.74,inf,4.51
21,1325.74,inf,4.51
