0,40.55,inf,1.21
1,40.55,inf,1.21
2,40.55,inf,1.21
3,40.55,inf,1.21
4,40.55,inf,1.21
5,40.55,inf,1.21
6,40.55,inf,1.21
7,40.55,inf,1.21
8,40.55,inf,1.21
9,40.55,inf,1.21
10,40.55,inf,1.21
11,40.55,inf,1.21
12,40.55,inf,1.21
13,64.25,inf,1.21
14,64.25,inf,1.21
15,64.25,inf,1.21
16,64.25,inf,1.21
17,64.25,inf,1.21
18,64.25,inf,1.21
19,64.25,inf,1.21
20,64.25,inf,1.21
21,40.55,inf,1.21
