0,288.68,0.35,0.71
1,288.68,0.35,0.71
2,288.68,0.35,0.71
3,288.68,0.35,0.71
4,333.91,0.35,0.71
5,306.23,0.35,0.71
6,297.46,0.35,0.71
7,306.23,0.35,0.71
8,297.46,0.35,0.71
9,288.68,0.35,0.71
10,288.68,0.35,0.71
11,288.68,0.35,0.71
12,288.68,0.35,0.71
13,288.68,0.35,0.71
14,288.68,0.35,0.71
15,308.65,0.35,0.71
16,308.65,0.35,0.71
17,306.23,0.35,0.71
18,306.23,0.35,0.71
19,288.68,0.35,0.71
20,288.68,0.35,0.71
21,288.68,0.35,0.71
