0,308.00,0.83,1.01
1,333.73,0.83,1.01
2,308.00,0.83,1.01
3,308.00,0.83,1.01
4,328.59,0.83,1.01
5,308.00,0.83,1.01
6,308.00,0.83,1.01
7,308.00,0.83,1.01
8,308.00,0.83,1.01
9,308.00,0.83,1.01
10,308.00,0.83,1.01
11,313.15,0.83,1.01
12,308.00,0.83,1.01
13,308.00,0.83,1.01
14,308.00,0.83,1.01
15,333.73,0.83,1.01
16,308.00,0.83,1.01
17,308.00,0.83,1.01
18,308.00,0.83,1.01
19,308.00,0.83,1.01
20,308.00,0.83,1.01
21,308.00,0.83,1.01
