0,324.90,inf,1.71
1,324.90,inf,1.71
2,324.90,inf,1.71
3,324.90,inf,1.71
4,324.90,inf,1.71
5,365.73,inf,1.71
6,352.12,inf,1.71
7,372.54,inf,1.71
8,495.03,inf,1.71
9,488.23,inf,1.71
10,488.23,inf,1.71
11,426.98,inf,1.71
12,324.90,inf,1.71
13,488.23,inf,1.71
14,495.03,inf,1.71
15,529.06,inf,1.71
16,515.45,inf,1.71
17,529.06,inf,1.71
18,461.01,inf,1.71
19,529.06,inf,1.71
20,474.62,inf,1.71
21,529.06,inf,1.71
