0,2017.17,inf,5.51
1,2737.19,inf,5.51
2,2437.18,inf,5.51
3,2377.18,inf,5.51
4,2797.19,inf,5.51
5,2617.19,inf,5.51
6,2197.17,inf,5.51
7,2497.18,inf,5.51
8,1837.16,inf,5.51
9,2437.18,inf,5.51
10,1897.16,inf,5.51
11,2737.19,inf,5.51
12,2077.17,inf,5.51
13,2197.17,inf,5.51
14,2437.18,inf,5.51
15,1837.16,inf,5.51
16,2797.19,inf,5.51
17,2077.17,inf,5.51
18,2257.17,inf,5.51
19,2677.19,inf,5.51
20,1897.16,inf,5.51
21,2077.17,inf,5.51
