0,2453.21,inf,4.01
1,2936.41,inf,4.01
2,3822.27,inf,4.01
3,3661.21,inf,4.01
4,3822.27,inf,4.01
5,3580.67,inf,4.01
6,4386.01,inf,4.01
7,4547.07,inf,4.01
8,3983.34,inf,4.01
9,3741.74,inf,4.01
10,3902.81,inf,4.01
11,3822.27,inf,4.01
12,3580.67,inf,4.01
13,3580.67,inf,4.01
14,3580.67,inf,4.01
15,3178.01,inf,4.01
16,2131.07,inf,4.01
17,2372.67,inf,4.01
18,2292.14,inf,4.01
19,2453.21,inf,4.01
20,2372.67,inf,4.01
21,2453.21,inf,4.01
